NO textures/1400x1400/fractal_wall.png
SO textures/1400x1400/fractal_wall.png
WE textures/1400x1400/fractal_wall.png
EA textures/1400x1400/fractal_wall.png
F 0,0,0  //0xFF0000FF
C 0,0,0  //0xFFA500FF


1111111111111
1E00000100001
1110111011101
1000001000001
1011101111011
1000100000011
1011110111101
1000000000001
1111111111111