NO /home/azubieta/Desktop/cub3d/textures/1400x1400/mountain/flat_mountains.png
SO /home/azubieta/Desktop/cub3d/textures/1400x1400/mountain/flat_mountains.png
WE /home/azubieta/Desktop/cub3d/textures/1400x1400/mountain/flat_mountains.png
EA /home/azubieta/Desktop/cub3d/textures/1400x1400/mountain/flat_mountains.png
F 220,100,0  //0xFF0000FF
C 225,30,0  //0xFFA500FF
      11111111111111111111
      10000000000000000001
 1111 10011111011111100001
 1001 10010001000000100001
 1001 10011111101110100001
 1000 00000000000000100001
 1111 10111111011111111111
 1000 10000001000000000001
 1011 10111101111111111001
 1000 10000000000000001001
 1000 10111111111110001001
 1000 10000000000000E00001
 1111 11111111111111111111