NO textures/1400x1400/pink/bermuda_square.png
SO textures/1400x1400/pink/bermuda_square.png
WE textures/1400x1400/pink/bermuda_square.png
EA textures/1400x1400/pink/bermuda_square.png
F 255,0,255
C 255,0,255
1111111111111111111111111
1000000000000000000000001
1011110111111111111011101
1000010100001000001010001
1011010111101110111011101
1001010000001000000010001
1011010111111111111011101
100000010000E000000100001
1011111110111111101111101
1000000000100000100000001
1011101111110111111011101
1000100000000000000010001
1011101111111111111011101
1000000000000000000000001
1111111111111111111111111