NO /home/azubieta/Desktop/cub3d/textures/1400x1400/rubik/blue.png

SO /home/azubieta/Desktop/cub3d/textures/1400x1400/rubik/green.png
WE /home/azubieta/Desktop/cub3d/textures/1400x1400/rubik/red.png

EA /home/azubieta/Desktop/cub3d/textures/1400x1400/rubik/pink.png

F 75,0,130





C 225,255,0


11111111111111111111
10000000000000000001
111110011111000011111111
100110010001000010100001
100110010001000010100001
1000E0000001111000100001
111111111111111111111111
100000000000000100000001
101110001111111100001111
100010000000000000001001
100010000000000000001001
100010000000000000000001
111111111111111111111111






