
F 0,0,255
C 135,206,250

NO /home/azubieta/Desktop/cub3d_github/textures/1400x1400/triangle/bermuda_triangle.png
SO /home/azubieta/Desktop/cub3d_github/textures/1400x1400/triangle/bermuda_triangle.png
WE /home/azubieta/Desktop/cub3d_github/textures/1400x1400/triangle/bermuda_triangle.png
EA /home/azubieta/Desktop/cub3d_github/textures/1400x1400/triangle/bermuda_triangle.png

1111111111111111111111111
1E00000000111100000000001
1111111001010010111111101
1000001001011010000000101
1011101011001011110110101
1000100000000010000100101
1010111111111010111100101
1000100000000010000000001
1011101111011110111111111
1000000001010000000000001
1111011101010111111111101
1000010001000000000000001
1011111111111111111011101
1000000000000000000000001
1111111111111111111111111