F 220,100,0
C 225,30,0
C 225,30,0
C 225,30,0

NO /home/azubieta/Desktop/cub3d_github/textures/textures_xpm/wall_1.xpm42
SO /home/azubieta/Desktop/cub3d_github/textures/textures_xpm/wall_2.xpm42
WE /home/azubieta/Desktop/cub3d_github/textures/textures_xpm/wall_3.xpm42
EA /home/azubieta/Desktop/cub3d_github/textures/textures_xpm/wood.xpm42


      11111111111111111111
      10000000000000000001
 1111 10111110001111100001
 1001 10000010001000100001
 1001 10111010001000100001
 1001 10000000000000100001
 1111 10011111111110111111
 1001 10010000000000100001
 1011 10010111111110101111
 1001 10010000000000100001
 1001 10010000000000100001
 1001 1001000000000W00001
 1111 11111111111111111111
