F 220,100,0
C 225,30,0

NO textures/textures_xpm/wall_4.xpm42
SO textures/textures_xpm/sprite\ 3.xpm42
WE textures/textures_xpm/wood.xpm42
EA textures/textures_xpm/wall_1.xpm42


      11111111111111111111
      10000000000000000001
 1111 10111110001111100001
 1001 10000010001000100001
 1001 10111010001000100001
 1000 10000000000000100001
 1111 10011111111110111111
 1000 10010000000000100001
 1011 10010111111110101111
 1000 10010000000000100001
 1000 10010000000000100001
 1000 10010000000000W00001
 1111 11111111111111111111
